R 680 450
C 100,100,0
1111111111
1000000001
1000000001
1000001001
1000000001
1000000001
1000000001
1001000001
1000000001
1000000001
1000000001
1000001001
100N000001
1000000001
1111111111
