R 660 480

NO ./textures/test/stone_brick_wall.xpm
SO ./textures/test/bookshelf.xpm
WE ./textures/test/mossy_stone_brick_wall.xpm
EA ./textures/test/sand_stone.xpm
S ./textures/sprites/sprite_oss117.xpm
S3 ./textures/sprites/sprite_1.xpm
S4 ./textures/sprites/sprite_2.xpm

C 50,50,50
F 80,50,20
11111111111111111111
12131000211213100021
10101310011010131001
10001111011000111101
10140431011014043101
12130100011213010001
11110111411111011141
10000411000000041101
1211N013211211001321
11111011111111101111
11111011111111101111
12131000211213100021
10101310011010131001
10001111011000111101
10140431011014043101
12130100011213010001
11110111411111011141
10000411000000041101
12110013211211001321
11111011111111101111
11111011111111101111
12131000211213100021
10101310011010131001
10001111011000111101
10140431011014043101
12130100011213010001
11110111411111011141
10000411000000041101
12110013211211001321
11111111111111111111
