R 680 450
111111111111111
100000000000001
10000000000W001
100000000000001
111111111111111
