R 680 450
C 100,100,0
111111111111111
100000000000000
10000000000W001
100000000000001
111111111111111
