R 680 460
NO ./textures/wall_1.xpm
SO ./textures/wall_2.xpm
WE ./textures/wall_3.xpm
EA ./textures/wall_4.xpm
S ./textures/sprite_1.xpm
S3 ./textures/sprite_2.xpm
C 60,60,60
F 170,120,160

11111111111111111111
10000000000000000001
10001010101010000001
10000000000000000001
100200000N0000000001
10000000000000000001
10010030000000030001
10000000000000000001
10010000000000000001
10000000020000010001
10010000000000000001
10000000000000000001
10000000000000000001
10000030000020000001
10200000000000000001
10000000000000000001
10000000010100000001
10000000000000003001
10000000000000000001
11111111111111111111
