R 640 480
11111111111111111111
10000000000000000001
10001010101010000001
10000000000000000001
100000000N0000000001
10000000000000000001
10010000000000000001
10000000000000000001
10010000000000000001
10000000000000010001
10010000000000000001
10000000000000000001
10000000000000000001
10000000000000000001
10000000000000000001
10000000000000000001
10000000010100000001
10000000000000000001
10000000000000000001
11111111111111111111
