R 680 450

1111111111111111111
1011111111111111111
1001111111111111111
1000111111111111111
1000011111111111111
1000001111111111111
1000000111111111111
1000000011111111111
1000000001111111111
1000000000111111111
1000000000011111111
1000000000001111111
1000000000000111111
1000000000000011111
1000000000000001111
1000000000000000111
1000000000N00000011
1000000000000000001
1111111111111111111
