R 680 460
NO ./textures/wall_1.xpm
SO ./textures/wall_2.xpm
WE ./textures/wall_3.xpm
EA ./textures/wall_4.xpm
S ./textures/sprite_1.xpm
C 50,150,255
F 170,120,160
11111111111111111111111111
10000000000000000000000001
10000000000000000000000001
10000000000000000000000001
10000000000000000000000001
10000000000002000000000001
10000000000000000000000001
10000002000000000000000001
10000000000000000000000001
10000000000000000000000001
10000000000001000000000001
10000000000000000000000001
10000000000000000000000001
10000000000000000000000001
10000000000000000000000001
1000000000000N000000000001
10000000000000000000000001
10000000000000000020000001
10000000000000000000000001
10000000000000000000000001
10000000000000000000000001
11111111111111111111111111
