R 680 460
NO ./textures/wall_1.xpm
SO ./textures/wall_2.xpm
WE ./textures/wall_3.xpm
EA ./textures/wall_4.xpm
S ./textures/sprite_1.xpm
S3 ./textures/sprite_2.xpm
S4 ./textures/sprite_macron.xpm
C 60,60,60
F 170,120,160
11111111111111111111111111
10000000000000000000000001
10000000300000000000030001
10000000000000000000000001
10000000000000000000000001
10004000000002000000040001
10000000000000000000000001
10000002000000000000000001
10000000000000000000000001
10004000000000000000000001
10000000000001000000030001
10000000000000000000000001
10000030000000000000000001
10000000000000000000000001
10000000000000000000000001
1000000000000N000000000001
10000000000000000000000001
10000000000000000020000001
10004000000000000000000001
10000000000000000000000001
10000000000000000000000001
11111111111111111111111111
