R 660 480
C 100,100,0

NO ./textures/test/stone_brick_wall.xpm
SO ./textures/test/bookshelf.xpm
WE ./textures/test/mossy_stone_brick_wall.xpm
EA ./textures/test/sand_stone.xpm
S ./textures/sprites/sprite_oss117.xpm
S3 ./textures/sprites/sprite_1.xpm
S4 ./textures/sprites/sprite_2.xpm

C 50,50,50
F 117,61,0
1111111111111111111111111111111111111111111111111111111111111111111
1000000000000000000000000100000000010000000000000000000000000000001
1000000000000040000000000100002000010000000000000400000000000000001
1000000000000000000000000100000000010000000000000000000000000000001
1111111111111111111110000100001000010000000000000000000000000000001
1000000000000000000000000100001000010000011111111111111111111100001
1000000000000000000000000100001000010000010000000000000000000100001
1000000000000020000000000100001000010000010000000000000000000100001
1000000000000000000000000100001000010000010000000000000000000100001
1000011111111111111111111100001000010000011111111111111110000100001
1000000000000000000000000000001000010000000000000001000000000100001
1000000000000000000004000000001000010000000000000001000000000100001
1000000300000000000000000000001000010000000400000001000000400100001
1000000000000000000000000000001000010000000000000001000000000100001
1000011111111111111111111111111000011111111111000001000010000100001
1000010000000000000013000000000000000000000001000000000010000100001
1000010000000000000010000000000000000000000001000000000010000100001
1000010000000000000010000000000000000000000001000000200010000100001
1000010000000000300010000000000000000000000001000000000010000100001
1000010000111111111110000000000000000400000001111111111110000100001
1000000000100000000000000000000000000000000000000000000000000100001
1000000000100000000000000000000000000000000000000000000000000100001
100000200010000000000000000000000N000000000000000000003000000100001
1000000000100000000000000000000000000000000000000000000000000100001
1111111111100001111110000000000000000000000001111111111111111100001
1000000000100001000010000000000000000000000001000010000000000000001
1000000000100001000010003000000000400000000001000010000000000000001
1000000000100001000010000000000000000000000001000010000000000400001
1000000000100001000010000000000000000000000001000010000000000000001
1000010000100000000011111111111000011111111111000010000111111100001
1000010000000000000000000000001000000000000000000010000100000100001
1000010000002000000040000000001000000000000000000010000100000100001
1000010000000000000000000000001000000000000002000010000100000100001
1111111111111111111111111100001000400000000000000010000100000000001
1000000000000000000000000100000000011111111111111110000100000000001
1003000000000000300000000100000000000000100000000010000100000000001
1000000400000000000000000103000000000000100000000010000111111111111
1000000000001000000000000111111111111111100000000000000000000000001
1000000000000000000000000000000000000000000000000000000000000000001
1000003000000000020000000000000000000000000001000000200040000000001
1000000000000000000000000000000000000000000001000000000000000000001
1111111111111111111111111111111111111111111111111111111111111111111
