R 960 780
C 100,100,0
NO ./textures/wall_1.xpm
SO ./textures/wall_2.xpm
WE ./textures/wall_3.xpm
EA ./textures/wall_4.xpm
1111111111111111111111111111111111111111111111111111111111111111111
1000000000000000000000000100000000010000000000000000000000000000001
1000000000000000000000000100000000010000000000000000000000000000001
1000000000000000000000000100000000010000000000000000000000000000001
1111111111111111111110000100001000010000000000000000000000000000001
1000000000000000000000000100001000010000011111111111111111111100001
1000000000000000000000000100001000010000010000000000000000000100001
1000000000000000000000000100001000010000010000000000000000000100001
1000000000000000000000000100001000010000010000000000000000000100001
1000011111111111111111111100001000010000011111111111111110000100001
1000000000000000000000000000001000010000000000000001000000000100001
1000000000000000000000000000001000010000000000000001000000000100001
1000000000000000000000000000001000010000000000000001000000000100001
1000000000000000000000000000001000010000000000000001000000000100001
1000011111111111111111111111111000011111111111000001000010000100001
1000010000000000000010000000000000000000000001000000000010000100001
1000010000000000000010000000000000000000000001000000000010000100001
1000010000000000000010000000000000000000000001000000000010000100001
1000010000000000000010000000000000000000000001000000000010000100001
1000010000111111111110000000000000000000000001111111111110000100001
1000000000100000000000000000000000000000000000000000000000000100001
1000000000100000000000000000000000000000000000000000000000000100001
100000000010000000000000000000000N000000000000000000000000000100001
1000000000100000000000000000000000000000000000000000000000000100001
1111111111100001111110000000000000000000000001111111111111111100001
1000000000100001000010000000000000000000000001000010000000000000001
1000000000100001000010000000000000000000000001000010000000000000001
1000000000100001000010000000000000000000000001000010000000000000001
1000000000100001000010000000000000000000000001000010000000000000001
1000010000100000000011111111111000011111111111000010000111111100001
1000010000000000000000000000001000000000000000000010000100000100001
1000010000000000000000000000001000000000000000000010000100000100001
1000010000000000000000000000001000000000000000000010000100000100001
1111111111111111111111111100001000000000000000000010000100000000001
1000000000000000000000000100000000011111111111111110000100000000001
1000000000000000000000000100000000000000100000000010000100000000001
1000000000000000000000000100000000000000100000000010000111111111111
1000000000001000000000000111111111111111100000000000000000000000001
1000000000000000000000000000000000000000000000000000000000000000001
1000000000000000000000000000000000000000000001000000000000000000001
1000000000000000000000000000000000000000000001000000000000000000001
1111111111111111111111111111111111111111111111111111111111111111111
