R 1100 960
C 100,100,0
1111111111111111111111111111111111111111111111111111111111111111111
1000000000000000000000000100000000010000000000000000000000000000001
1000000000000000000000000100000000010000000000000000000000000000001
1000000000000000000000000100000000010000000000000000000000000000001
1111111111111111111110000100001000010000000000000000000000000000001
1000000000000000000000000100001000010000000000000000000000000000001
1000000000000000000000000100001000010000000000000000000000000000001
1000000000000000000000000100001000010000000000000000000000000000001
1000000000000000000000000100001000010000000000000000000000000000001
1000011111111111111111111100001000010000000000000000000000000000001
1000000000000000000000000000001000010000000000000000000000000000001
1000000000000000000000000000001000010000000000000000000000000000001
1000000000000000000000000000001000010000000000000000000000000000001
1000000000000000000000000000001000010000000000000000000000000000001
1000011111111111111111111111111000011111111111000000000000000000001
1000010000000000000010000000000000000000000001000000000010000100001
1000010000000000000010000000000000000000000001000000000010000100001
1000010000000000000010000000000000000000000001000000000010000100001
1000010000000000000010000000000000000000000001000000000010000100001
1000010000111111111110000000000000000000000001111111111110000100001
1000010000100000000000000000000000000000000000000000000000000100001
1000000000100000000000000000000000000000000000000000000000000100001
100000000010000000000000000000000N000000000000000000000000000100001
1000000000100000000000000000000000000000000000000000000000000100001
1000000000100001111110000000000000000000000001111111111111111100001
1000000000000001000010000000000000000000000001000000000000000000001
1000000000000000000010000000000000000000000001000000000000000000001
1000000000000000000010000000000000000000000001000000000000000000001
1000000000000000000010000000000000000000000001000000000000000000001
1000000000000000000011111111111000011111111111000000000000000000001
1000000000000000000000000000001000010000000000000000000000000000001
1000000000000000000000000000001000010000000000000000000000000000001
1000000000000000000000000000000000000000000000000000000000000000001
1000000000000000000000000000000000000000000000000000000000000000001
1000000000000000000000000000000000000000000000000000000000000000001
1000000000000000000000000000000000000000000000000000000000000000001
1000000000000000000000000000000000000000000000000000000000000000001
1000000000000000000000000000000000000000000000000000000000000000001
1000000000000000000000000000000000000000000000000000000000000000001
1000000000000000000000000000000000000000000000000000000000000000001
1000000000000000000000000000000000000000000000000000000000000000001
1111111111111111111111111111111111111111111111111111111111111111111
